11111111111111111
10X000001E00000C1
10000000011111001
10P00C11000000001
10000111100000001
11111111111111111
