1111111111111111111111111111111111
1X000000000E0Y000000X0000000001111
100000000000000C00000C000000000001
10100101001000001010010000000100C1
1010010010101010001001000Y00010101
1P0000000C00C00000000000X0000000C1
1111111111111111111111111111111111