111111111
100100011
1P0000011
10010E011
111111111
1CCCCC111
111111111