11111
1E101
10001
1C001
11111
11P11
11111